w                                               w
w                                               w
w                                               w
w                                               w
w                                               w
w                                               w
w                         b          b         ew
w                  wwwwwwwwwwwwwwwwwwwwwwwwwwwwww
w        d    wwww                              w
w     wwww                                      w
w          d                                    w
w          wwww                                 w
w                 d                             w
w              wwww                             w
w          wwww                                 w
w      wwww                                     w
w s   d                                         w
wwwwwwwwwwwwwwwwwwwwwwwwwwwwwwwwwwwwwwwwwwwwwwwww
